12341T3412341234
23BABABAABAB1241
33AT234T234A2334
ABB234BABATB4342
121212ATTBAA3T42
123132B312341234
234133AT234123TA
123412BBABABABAB
2341234123412341