              #####################        ###
 ###############P      O  X        ########  #
##       O      X   X  O         X   O       #
 ##############   P   O  X        #########  #
              ###     #######   ###        ###
                #    #      #X  #
               #    #       #O  #
               #####        #####