              #####################        ###
 ###############P      O  X        ########  #
##       O      X   X  O         X   O       #
 ##############       O  X   O    #########  #
              ###     #######   ###        ###
                #    #      #X  #
               #    #       #O  #
               #####        #####