***************X****X
XXX*XXXXXXXXXXXXXXX*X
******************X*X
XXXXXXXXXXXXXXXXX***X
XXXXXXXXXXXXXXXXXXX*X
XXXXXXXXXX********X*X
***********XXXXXX***X
XXXXXXXXXXXXXXXXXXXXX
*********************