***************X****X*X*XXXXXXXXXXXXXX
XXX*XXXXXXXXXXXXXXX*X****************X
******************X*X*X*****X********X
XXXXXXXXXXXXXXXXX***X*X*****XXXX*****X
XXXXXXXXXXXXXXXXXXX*X*X*****X********X
XXXXXXXXXX********X*X*X*****X********X
***********XXXXXX***X*******X********X
XXXXXXXXXXXXXXXXXXX*XX*X*XXXXXXXXXX*XX
***********************X**************